"Large" : "A map with normal, rough, and impassable terrain that is larger than the camera's display area."
---
47 x 32 : 1
---
v v v v v v v v v v v v v v v v v v v v v v v v v v v v v v v v v v v v v v v v v v v v v v v
v m m m m m m m m m m m m m m m m m m m m m m m m m m m m m m m m m m m m m m m m m m m m m v
v m m m m r r r r g g g g g g g g r g g g g g g r g r g g g g m m m m m m m m m m m m m m m v
v m m m r r r g g g g g g g g g g r r r g g g r r r r g g g g g g g g g g g m m m m m m m m v
v m m r r r g g g g g g g g g g r r g g g g g g g g r r g g g g g g g g g g r r g g g m m m v
v m m r r g g g g r r r g g g g g g r g g g g g g g g g g g g r r g g g g r r r r r r r m m v
v m r r r r g g g r g r g g g g g g g g g g r r g g g g g g r r g g g g r g g r r r r m m m v
v m r r r g g g g g g g g g r r g g g g g r r g g g g g g g g g g g g r g g g g g r r r m m v
v m g g g g g g g g g g g g g g g g g g g g g g g g g r g g g g g g r g g g g r g g r r r m v
v m g g g g g r g g g g g g g g g g r g g g g g g g g g g g g g r g g g g g g g g g r r r m v
v m g g g g g r r r g g g g g g g g g g g g g g g r g g g g r g g g g r g g g g g r r r m m v
v m m m m r g g g r r g g g g g r r g g g g g g g g r r g g g g g g g r g g g g g g r r g m v
v m m m r g g g g g g g g g g g g g g g g g g g g g r r g g g g g g g g g g g g g g g g r m v
v m m r r r g g g g g g g g g g g g g g m m g g g g g g g g g r r g g g g g g g g g g g r m v
v m m r g g g g g g g g g g g g g g g g m m g g g g g g g g g g g g g g g g g g r r g g r m v
v m m m r r g g g g r r g g g g g g g m m m m g g g g g g g g r r g g g g g g g g g g g r m v
v m m m r g g g g r r g g g g g g g g m m m m m m m m g g g g g r r g g g g g g g g g g g m v
v m r r g g g g g r g g g g g g g g g g m m m m m m g g g g g g g r g g g g g g g g g g g m v
v m r r r g g g g g g g g g g g g g g g g m m m m m g g g g g g g g g g g g g r r r g g m m v
v m m r r g g g g r r g g g g g g r g g g g m m m m g g g g r r g g g g r g g g r r g g m m v
v m m r r r g g g g g r r g g g g g g r g g g g m m m m g g g g r r g g g g g g g r g g r m v
v m m r r r g g g r g g g r r r g g g g g g g g g m m r g g g g g g r g g g g g g g g g r m v
v m m r r r g g g g g g g g r g g g g g g r g g g g g g g g g g g g r g g g g g g g g g g m v
v m m m r g g g g g g g g g g g g g g g g g g g r g g g g g g g g r g g g g g g g g g g g m v
v m m m r r g g g g g g r r g g g g g g g g g g r r g g g g g g g g g g g g g g g r g g g m v
v m r r r r g g g g g g g g g r r g g g g g g g g g g g g g g g g g g g g r r g g g g g g m v
v m r r r r g g g g g g g g g g g g r g g g g g g g g g g g g g r r g g g g g g g g r g r m v
v m m m m m m m m g g g g g g r r r g g g g g g g g g g g g g g g g g g g g r r g m r r m m v
v m g g g g g g g g g g r r r r g g g g r g g g r r r r g g m m r r g r g g g g g m r r m m v
v m m m m m m m m g g g g g g r r r g g g g g r r r r r r m m m m g r g r r r r m m m m m m v
v m m m m m m m m m m m m m m m m m m m m m m m m m m m m m m m m m m m m m m m m m m m m m v
v v v v v v v v v v v v v v v v v v v v v v v v v v v v v v v v v v v v v v v v v v v v v v v
---
soldier - h @ 12, 11;
soldier - h @ 13, 12;
soldier - h @ 14, 13;
soldier - h @ 15, 14;
soldier - h @ 16, 15;
archer - h @ 14, 14;
archer - h @ 15, 15;
siege - h @ 12, 12;
cavalry - h @ 11, 10;
hiker - h @ 17, 16;
tower - h @ 19, 12;

soldier - 1 @ 32, 21;
soldier - 1 @ 33, 22;
soldier - 1 @ 34, 23;
soldier - 1 @ 35, 24;
soldier - 1 @ 36, 25;
archer - 1 @ 35, 23;
archer - 1 @ 36, 24;
siege - 1 @ 34, 22;
cavalry - 1 @ 31, 20;
hiker - 1 @ 37, 26;
tower - 1 @ 21, 28;
